10 10
111111111111111111111
100000100000000000001
101010101111111011101
101010100010001010001
101010111110101010111
101010000010100010001
101011111010101111111
101000101010101000001
101110101010101011101
101000100000101010101
101011101111111010101
101000101010000010101
101110101011111110101
100010100010001000001
111110111110101011111
100000100000101010001
101111101111101010101
100010001000001000101
101010111011111111101
101000001000000000001
111111111111111111110
