10 10
111111111111111111111
100010000000000000001
101011111011101111111
101000001000100000001
101111101110111111101
101010001000100000101
111010111011101111101
101000101000100000101
101011101110111110101
101000100010001000101
101110101111101011101
101000100000001010001
101011101111111010101
100010101000000010101
101110101111101010101
100010001000001010101
111010111011111010111
100010000010000010001
101111111111111111101
100000000000000000001
111111111111111111111
